1111111
1P0E011
1110C01
1000011
1111111
