1111111111111
1Z0000000Z001
1A00011111001
1P0X01E000001
1111111111111
