1111111
1P111C1
1C001E1
1011101
10C0001
1111111
