1111111111111
1E00000000C11
100P011111001
100011E0000E1
1111111111111
