1111111111111
1000000000001
1000011111001
1P0001E000001
1111111111111