111111111111
100000000001
100000000001
1P0000000E01
100000000001
100000000C01
111111111000
