1111111111111
1000000000011
100001111111
1P0001E000001
1111111111111
