1111111
1P0C011
1110C01
1000E11
1111111