1111111111111111111111111
1000000E0000C0000000000C1
1000000000000000000000001
100000000000000C000000001
1P00000000000000000000001
10000000000000000000C0001
1000000000000000000000001
1000000000000000C00000C01
1000000000000000000000001
100000000C000000000000001
1111111111111111111111111
