111111
1000E1
100111
1001C1
100111
1P00C1
111111
