1111111111111111111111111
1000000E1000C0000000000C1
1000111110001001100010001
100000000000100C000010001
1P00000000000000000000001
10000000000000010001C0001
1111111110010000010001001
1111111110010000C10001C01
1111111110000001010001001
111111111C000000000000001
1111111111111111111111111