111111
1000E1
100C01
10P001
100001
111111