111111
1000E1
100C01
100001
1P0001
111111
